{
    "value": [
        4829330,
        4141734,
        3984428,
        5354246,
        6492121,
        7081825,
        7092841,
        6941515,
        6019505,
        4823117,
        5742972,
        9609981,
        7078001,
        7360653,
        7006748,
        5988184,
        4696026,
        5539358,
        6697728,
        7497067,
        7075676,
        7208733,
        6584542,
        4944359,
        5480217,
        6627209,
        6838983,
        8691146,
        6859604,
        6170898,
        4838234,
        5212333,
        6200815,
        6895966,
        6987321,
        6314480,
        5515708,
        4386615,
        4934297,
        6163487,
        6091397,
        6329075,
        6150831,
        5254458,
        4240307,
        4813906,
        5776033,
        6223704,
        6309305,
        6415033,
        5982546,
        4647675,
        5318601,
        6397854,
        6575449,
        6931938,
        6796097,
        6204483,
        4729126,
        5479504,
        8708770,
        7123955,
        7313355,
        7300354,
        6185477,
        5070343,
        5618309,
        6397903,
        7358740,
        7516457,
        7638235,
        6005386,
        4985656,
        6470571,
        7426605,
        8133376,
        7885526,
        7462056,
        6327442,
        5229783,
        5924037,
        7354407,
        8408241,
        8371010,
        10963943,
        6926928,
        6770720,
        6966035,
        7774004,
        8805151,
        8592357,
        7358194,
        6956967,
        5679550,
        5502766,
        7920631,
        8943899,
        8634004,
        8296770,
        7259003,
        6721790,
        7150510,
        8232140,
        8656903,
        8044415,
        7842736,
        6965554,
        6840152,
        7235135,
        8327389,
        9118587,
        9003396,
        8508535,
        7596432,
        7023270,
        7142122,
        8633126,
        8775268,
        8856823,
        8167569,
        6841736,
        8452923,
        7065715,
        7996373,
        8486219,
        8947079,
        8224701,
        6719275,
        6720031,
        6976608,
        8223378,
        8854223,
        7999174,
        7465342,
        6419494,
        4260255,
        5435929,
        9680366,
        8859808,
        8629257,
        8340817,
        7203300,
        6740237,
        6830008,
        8240195,
        8752567,
        9091617,
        8089359,
        6887852,
        6101481,
        6266872,
        7402856,
        9951488,
        10233382,
        9486253,
        8845400,
        7951277,
        6922304,
        7462121,
        7979197,
        7981719,
        7727153,
        6814461,
        6446459,
        6529322,
        7056709,
        7712098,
        9780644,
        7677815,
        6757906,
        6164103,
        6462813,
        7593680,
        7795298,
        7665855,
        7634350,
        7019908,
        6949662,
        7385640,
        7295039,
        8081413,
        8798237,
        8050587,
        7063061,
        6671699,
        6571621,
        7279262,
        7944346,
        8099615,
        7977645,
        7459985,
        6509094,
        6947160,
        7767401,
        8071287,
        9007864,
        8430194,
        7555651,
        6203769,
        6456457,
        7163804,
        7208484,
        7389189,
        7649228,
        6489287,
        5827615,
        6206680,
        7304637,
        7661400,
        7775429,
        8338285,
        6926161,
        5750225,
        6590294,
        7285653,
        7764592,
        8135940,
        8092666,
        7330439,
        6097760,
        7723806,
        8168643,
        8480975,
        9494012,
        8947547,
        8194218,
        6171732,
        7099420,
        8550653,
        8823318,
        9310471,
        9274090,
        7726660,
        6405218,
        7203110,
        9740060,
        9085213,
        9786167,
        9421951,
        8245207,
        6569936,
        7734493,
        8741495,
        10080904,
        7703093,
        7613726,
        7761113,
        6865620,
        7897138,
        8616469,
        9087543,
        9662860,
        9748401,
        7830869,
        6761248,
        7987192,
        8977113,
        8924994,
        9036062,
        8865388,
        7630069,
        6728889,
        7470815,
        8718786,
        9277409,
        9296065,
        8950157,
        7528123,
        6484762,
        7110921,
        8413991,
        9228518,
        9057794,
        8043779,
        6800806,
        5941941,
        6601410,
        8228826,
        8798243,
        8933950,
        8164319,
        6789574,
        5876500,
        6777629,
        8280363,
        8242492,
        9338508,
        7879585,
        6189950,
        5382247,
        6277848,
        8768436,
        8806312,
        8906437,
        7729360,
        6392989,
        5561251,
        6589562,
        8265618,
        8291153,
        8375884,
        8152101,
        6283496,
        5631733,
        5852065,
        7478138,
        8624197,
        8296849,
        7737029,
        6770560,
        6128185,
        7304859,
        9472488,
        9467254,
        9525385,
        8219595,
        6671237,
        6115633,
        6768960,
        8683592,
        8525865,
        8743636,
        9247621,
        7368414,
        6329371,
        7313621,
        8897123,
        9206559,
        8636702,
        8526047,
        6893664,
        6077322,
        7570706,
        10166208,
        9998444,
        10267959,
        11269508,
        7897353,
        6757354,
        8310866,
        9821480,
        9126142,
        8603829,
        9141563,
        7083717,
        5726141,
        5373868,
        5068307,
        2719275
    ]
}